##################################################
#       ::::::::::::::::::::::::::::::::::::::::::
# # # # #:#:#:#:#:#:#:#:#:#:#:#:#:#:#:#:#:#:#:#:#:
#       ::::::::::::::::::::::::::::::::::::::::::
#:#:#:#:#:#:#:#:#:#:#:#:#:#:#:#:#:#:#:#:#:#:#:#:#:
#:::::::::::::::::::::::::::::::::::::::::::::::::
#:#:#:#:#:#:#:#:#:#:#:#:#:#:#:#:#:#:#:#:#:#:#:#:#:
#:::::::::::::::::::::::::::::::::::::::::::::::::
#:#:#:#:#:#:#:#:#:#:#:#:#:#:#:#:#:#:#:#:#:#:#:#:#:
#:::::::::::::::::::::::::::::::::::::::::::::::::
#:#:#:#:#:#:#:#:#:#:#:#:#:#:#:#:#:#:#:#:#:#:#:#:#:
#::::::::::::::::::::::::::::::::::::::::::       
#:#:#:#:#:#:#:#:#:#:#:#:#:#:#:#:#:#:#:#:#:# # # # 
#::::::::::::::::::::::::::::::::::::::::::       
##################################################