###################################################
#       ::::::::::::::::::::::::::::::::::::::::::#
# # # # #:#:#:#:#:#:#:#:#:#:#:#:#:#:#:#:#:#:#:#:#:#
#       ::::::::::::::::::::::::::::::::::::::::::#
#:#:#:#:#:#:#:#:#:#:#:#:#:#:#:#:#:#:#:#:#:#:#:#:#:#
#:::::::::::::::::::::::::::::::::::::::::::::::::#
#:#:#:#:#:#:#:#:#:#:#:#:#:#:#:#:#:#:#:#:#:#:#:#:#:#
#:::::::::::::::::::::::::::::::::::::::::::::::::#
#:#:#:#:#:#:#:#:#:#:#:#:#:#:#:#:#:#:#:#:#:#:#:#:#:#
#:::::::::::::::::::::::::::::::::::::::::::::::::#
#:#:#:#:#:#:#:#:#:#:#:#:#:#:#:#:#:#:#:#:#:#:#:#:#:#
#::::::::::::::::::::::::::::::::::::::::::       #
#:#:#:#:#:#:#:#:#:#:#:#:#:#:#:#:#:#:#:#:#:# # # # #
#::::::::::::::::::::::::::::::::::::::::::       #
