##################################################
       ::::::::::::::::::::::::::::::::::::::::::#
 # # # #:#:#:#:#:#:#:#:#:#:#:#:#:#:#:#:#:#:#:#:#:#
       ::::::::::::::::::::::::::::::::::::::::::#
:#:#:#:#:#:#:#:#:#:#:#:#:#:#:#:#:#:#:#:#:#:#:#:#:#
:::::::::::::::::::::::::::::::::::::::::::::::::#
:#:#:#:#:#:#:#:#:#:#:#:#:#:#:#:#:#:#:#:#:#:#:#:#:#
:::::::::::::::::::::::::::::::::::::::::::::::::#
:#:#:#:#:#:#:#:#:#:#:#:#:#:#:#:#:#:#:#:#:#:#:#:#:#
:::::::::::::::::::::::::::::::::::::::::::::::::#
:#:#:#:#:#:#:#:#:#:#:#:#:#:#:#:#:#:#:#:#:#:#:#:#:#
::::::::::::::::::::::::::::::::::::::::::       #
:#:#:#:#:#:#:#:#:#:#:#:#:#:#:#:#:#:#:#:#:# # # # #
::::::::::::::::::::::::::::::::::::::::::       #
##################################################