###################################################
#                                                 #
# # # #:# # # # # #:# # # # # # # # # # # # # # # #
#  :         ###                                  #
# # # #:# #:# #:# #:# # # # # # # # # # # # # # # #
#          ####           ::                      #
# # # # # #:# # # #:# # # # # # # # # # # # # # # #
#    :   :     :                                  :
# # # # # # # # # # # # # # # # # # # # # # # # # #
#                                                 #
###################################################
