####################
#   :::  $$        #
# # #a# # # # #a# ##
#    Oa$$:   :::   #
####################
